0 11 22 81 81 81 44 85 81 81 81 81 81 81 81 81 20 21  
88 1 33 77 77 77 87 86 77 77 77 77 77 77 77 77 23 93 
88 2 3 3 3 3 3 3 4 3 3 3 3 3 3 3 25 93 
88 27 12 10 9 8 7 6 5 82 54 56 57 58 59 60 26 93 
88 28 13 14 15 16 17 18 19 51 67 65 64 63 62 61 82 93 
88 29 82 82 82 82 83 83 83 52 68 69 70 71 72 73 82 93 
88 30 82 82 82 82 45 46 47 53 80 79 78 76 75 74 82 93 
88 31 82 82 82 82 50 49 48 51 67 65 64 63 62 61 82 93 
88 32 82 82 82 82 83 83 83 52 68 69 70 71 72 73 82 93 
91 34 82 82 82 82 82 82 82 82 82 82 82 82 82 82 82 93 
91 37 40 42 42 42 42 42 42 42 42 42 42 42 42 42 82 93 
38 39 41 43 43 43 43 43 43 43 43 43 43 43 43 43 82 93 