326 327 308 308 330 331 332 308 308 327 308 308 301 302 329 307 
326 328 324 324 333 334 335 324 324 328 324 324 303 304 329 307 
326 323 323 323 310 314 309 323 323 323 323 323 305 306 329 307 
326 324 324 324 315 316 317 324 324 324 324 324 324 324 329 307 
326 323 323 323 323 323 323 323 323 323 323 323 323 323 329 307 
326 324 324 324 324 324 324 324 324 324 336 337 338 324 329 307 
326 323 323 323 323 323 318 319 320 323 323 339 340 341 329 307 
326 324 324 324 324 324 311 312 313 324 324 324 324 324 329 307 
326 325 325 325 325 325 321 323 322 325 325 325 325 325 329 307 