26 27 8 8 30 31 32 8 8 27 8 8 1 2 29 7 
26 28 24 24 33 34 35 24 24 28 24 24 3 4 29 7 
26 23 23 23 10 14 9 23 23 23 23 23 5 6 29 7 
26 24 24 24 15 16 17 24 24 24 24 24 24 24 29 7 
26 23 23 23 23 23 23 23 23 23 23 23 23 23 29 7 
26 24 24 24 24 24 24 24 24 24 36 37 38 24 29 7 
26 23 23 23 23 23 18 19 20 23 23 39 40 41 29 7 
26 24 24 24 24 24 11 12 13 24 24 24 24 24 29 7 
26 25 25 25 25 25 21 23 22 25 25 25 25 25 29 7 