0 1 2 3 1 2 3 0 1 2 1 2 3 4 5 6 
0 1 2 3 1 2 3 0 1 2 2 2 3 7 8 9 
10 11 12 13 2 43 1 44 2 43 1 43 3 14 15 16 
17 18 19 20 2 24 1 24 2 24 1 24 1 2 3 24 
21 22 23 24 24 24 24 24 24 24 24 24 24 24 24 24
25 26 27 1 2 24 3 28 29 30 2 24 2 3 24 3
31 32 33 1 2 43 3 34 35 36 2 43 2 37 38 39 
0 1 2 1 3 1 2 1 2 3 1 3 1 40 41 42