500 501 502 503 501 502 503 500 501 502 501 502 503 504 505 506
500 501 502 503 501 502 503 500 501 502 502 502 503 507 508 509
510 511 512 513 502 514 501 515 502 514 501 514 503 516 517 518
519 520 521 522 502 523 501 523 502 523 501 523 501 502 503 523
524 525 526 523 523 523 523 523 523 523 523 523 523 523 523 523
527 528 529 501 502 523 503 530 531 532 502 523 502 503 523 503
533 534 535 501 502 514 503 536 537 538 502 514 502 539 540 541
500 501 502 501 503 501 502 501 502 503 501 503 501 542 543 544
