501 502 503 504 502 503 504 500 501 502 502 503 504 513 514 515
501 502 503 504 502 503 504 500 501 502 503 503 504 529 530 531
532 533 534 535 503 629 501 630 503 629 501 629 504 545 546 547
548 549 550 551 502 567 501 567 503 567 501 567 502 503 504 567
564 565 566 567 567 567 567 567 567 567 567 567 567 567 567 567
580 581 582 501 502 567 503 587 588 589 503 567 503 504 567 504
596 597 598 501 502 629 503 603 604 605 503 629 503 609 610 611
500 501 502 501 503 501 502 501 502 503 501 503 501 626 627 628