501 502 503 504 502 503 504 500 501 502 502 503 504 505 506 507
501 502 503 504 502 503 504 500 501 502 503 503 504 508 509 510
510 511 512 513 503 543 501 544 503 543 501 543 504 514 515 516
517 518 519 520 503 524 501 524 503 524 501 524 502 503 504 524
521 522 523 524 524 524 524 524 524 524 524 524 524 524 524 524
525 526 527 501 502 524 503 528 529 530 503 524 503 504 524 504
531 532 533 501 502 543 503 534 535 536 503 543 503 537 538 539
500 501 502 501 503 501 502 501 502 503 501 503 501 540 541 542