138 115 116 117 103 138 145 145 145 138 138 132 151 149 150 138 133 133 108 144 133
138 138 118 119 138 138 145 140 145 138 138 142 112 113 114 138 133 133 120 122 133
138 138 108 144 138 138 145 145 145 138 138 115 116 117 103 138 133 133 133 133 133
138 138 120 122 138 138 140 145 145 138 138 138 118 119 138 138 133 133 133 133 132
138 138 138 138 138 138 145 145 145 138 138 138 108 144 138 138 133 133 133 133 142
138 138 138 138 138 138 121 145 121 138 138 133 120 122 138 138 133 133 133 133 111
138 138 138 138 138 138 129 139 129 138 138 138 138 138 138 138 133 133 134 134 100
136 136 136 136 136 136 129 139 129 136 136 136 136 136 136 136 136 136 136 136 136
136 124 125 126 127 136 129 139 129 136 136 136 136 136 136 136 136 136 136 136 136
136 128 143 109 141 136 129 139 129 136 124 125 126 127 136 136 136 136 136 136 136
133 111 112 113 114 133 130 139 130 133 142 143 109 110 133 133 133 133 133 133 148
133 115 116 117 103 133 145 145 145 133 111 112 113 114 133 133 133 133 133 133 142
133 133 104 119 133 133 145 140 145 133 100 101 102 103 133 133 133 133 133 133 142
133 133 108 144 133 133 145 145 145 133 133 118 119 133 133 133 133 133 133 133 100
133 133 120 122 133 133 140 145 145 133 133 108 144 133 133 133 133 133 133 133 132
133 133 133 133 133 133 133 133 133 133 133 120 122 133 133 133 133 133 133 133 142
133 133 133 133 133 133 133 133 133 133 133 133 133 133 133 133 133 133 133 133 100
151 149 150 133 133 133 133 133 133 133 133 133 133 133 133 133 133 133 133 133 132
143 143 114 133 133 133 133 133 133 133 133 133 133 133 133 133 138 138 138 138 142
116 116 114 133 133 148 151 149 150 133 133 133 133 133 148 151 149 150 138 138 100
101 102 103 137 137 142 112 113 114 148 151 149 150 137 142 112 113 114 137 137 137