38 15 16 17 3 38 45 45 45 38 38 32 51 49 50 38 33 33 8 44 33
38 38 18 19 38 38 45 40 45 38 38 42 12 13 14 38 33 33 20 22 33 
38 38 8 44 38 38 45 45 45 38 38 15 16 17 3 38 33 33 33 33 33 
38 38 20 22 38 38 40 45 45 38 38 38 18 19 38 38 33 33 33 33 32 
38 38 38 38 38 38 45 45 45 38 38 38 8 44 38 38 33 33 33 33 42 
38 38 38 38 38 38 21 45 21 38 38 33 20 22 38 38 33 33 33 33 11 
38 38 38 38 38 38 29 39 29 38 38 38 38 38 38 38 33 33 34 34 0 
36 36 36 36 36 36 29 39 29 36 36 36 36 36 36 36 36 36 36 36 36 
36 24 25 26 27 36 29 39 29 36 36 36 36 36 36 36 36 36 36 36 36 
36 28 43 9 41 36 29 39 29 36 24 25 26 27 36 36 36 36 36 36 36 
33 11 12 13 14 33 30 39 30 33 42 43 9 10 33 33 33 33 33 33 48 
33 15 16 17 3 33 45 45 45 33 11 12 13 14 33 33 33 33 33 33 42 
33 33 4 19 33 33 45 40 45 33 0 1 2 3 33 33 33 33 33 33 42 
33 33 8 44 33 33 45 45 45 33 33 18 19 33 33 33 33 33 33 33 0 
33 33 20 22 33 33 40 45 45 33 33 8 44 33 33 33 33 33 33 33 32 
33 33 33 33 33 33 33 33 33 33 33 20 22 33 33 33 33 33 33 33 42 
33 33 33 33 33 33 33 33 33 33 33 33 33 33 33 33 33 33 33 33 0 
51 49 50 33 33 33 33 33 33 33 33 33 33 33 33 33 33 33 33 33 32 
43 43 14 33 33 33 33 33 33 33 33 33 33 33 33 33 38 38 38 38 42 
16 16 14 33 33 48 51 49 50 33 33 33 33 33 48 51 49 50 38 38 0 
1 2 3 37 37 42 12 13 14 48 51 49 50 37 42 12 13 14 37 37 37 
