45 45 45 45 45 45 45 45 45 45 45 45 45 40 45 45 56 56 56 56 
45 45 45 45 45 40 45 45 45 45 45 45 45 45 45 45 40 56 56 56 
37 37 45 45 45 45 45 45 45 45 45 45 45 45 45 37 60 60 60 60 
37 37 37 45 45 45 45 45 40 45 45 45 40 45 45 37 60 60 60 60 
37 37 37 37 45 45 45 45 45 45 45 45 45 45 37 37 61 62 62 62 
37 37 37 37 37 45 45 45 45 45 45 45 45 37 37 61 68 60 60 60 
62 62 62 62 62 63 70 70 70 70 70 70 64 62 62 68 60 60 60 60 
37 37 37 37 37 79 75 75 75 75 75 75 81 37 37 37 60 60 60 60 
37 37 37 37 60 79 75 75 75 75 75 75 81 60 60 72 60 60 60 60 
60 60 72 60 60 79 80 80 80 80 80 80 81 60 76 77 78 60 60 60 
60 76 77 78 60 60 45 45 45 40 45 45 60 60 82 83 84 60 60 60 
60 82 83 84 60 60 45 40 45 45 45 45 60 60 86 87 88 60 60 60 
60 86 87 88 60 60 45 45 45 45 45 45 60 60 60 90 60 60 60 60 
60 60 90 60 60 60 45 45 45 40 45 45 60 60 60 94 60 60 60 60 
60 60 94 60 60 60 60 45 45 45 45 60 60 60 60 60 60 60 60 60 
60 60 60 60 60 60 60 45 45 45 45 60 60 60 60 60 60 60 97 54 
60 60 60 60 60 60 97 92 92 92 92 54 54 54 54 54 54 54 98 89 
60 60 60 60 60 97 98 89 89 89 89 89 89 89 89 89 89 89 89 89 
60 60 97 54 54 98 89 89 89 89 89 89 89 89 89 89 89 89 89 89 
60 97 98 89 89 89 89 89 89 89 89 89 89 89 89 89 89 89 89 89 

