276 278 278 264 263 262 278 275 278 278 278 278 268 267 265 274 273 272 278 278 276 264 263 262 278 275 278 278 278 212 210 209
264 263 262 268 267 265 278 276 264 263 262 278 271 270 269 278 275 278 278 278 278 268 267 265 278 276 264 263 262 212 210 209
268 267 265 271 270 269 278 278 268 267 265 278 274 273 272 278 276 278 278 278 278 271 270 269 278 278 268 267 265 212 210 209
271 271 269 274 273 272 278 278 271 270 269 278 278 275 278 278 278 264 263 262 278 274 273 272 278 278 271 270 269 212 210 209
274 273 272 278 275 278 264 263 274 273 272 278 278 276 278 278 278 268 267 265 278 278 275 278 278 278 274 273 272 212 210 209
278 275 278 278 276 278 268 267 265 275 278 278 278 278 278 278 278 271 270 269 278 278 276 278 278 278 278 275 278 212 210 202
278 276 278 278 278 278 271 270 269 276 278 278 278 278 278 278 278 274 273 272 278 278 278 278 278 278 278 276 278 212 210 202
278 278 278 278 278 278 274 273 272 278 278 278 278 278 239 230 221 278 275 278 278 278 278 264 263 262 278 278 278 212 210 202
278 278 264 263 262 278 278 275 278 278 278 278 278 248 240 231 223 278 276 278 278 278 278 268 267 265 278 278 278 212 210 202
262 278 268 267 265 278 278 276 278 278 278 278 256 249 241 232 224 278 278 278 278 278 278 271 270 269 278 278 278 212 210 209
265 278 271 270 269 278 278 264 263 262 278 278 257 250 242 234 225 216 278 222 211 200 278 274 273 272 278 278 215 266 205 206
269 278 274 273 272 278 278 268 267 265 278 278 258 251 243 235 226 217 278 255 244 233 278 278 275 278 278 215 266 205 206 278
272 278 278 275 278 278 278 271 270 269 278 278 259 252 245 236 227 218 278 201 210 202 278 278 276 278 215 266 205 206 264 263
278 278 278 276 278 278 278 274 273 272 278 221 260 253 246 237 228 219 278 201 210 202 278 278 278 215 266 205 206 278 268 267
278 278 278 264 263 262 278 278 275 278 278 221 261 254 247 238 229 220 278 201 210 202 278 278 215 266 205 206 278 278 269 269
278 278 278 268 267 265 278 278 276 215 277 277 214 214 277 277 214 277 277 266 210 288 277 277 266 210 206 264 263 262 274 270
278 278 278 271 270 269 278 278 278 212 210 210 210 210 210 210 210 210 210 210 210 210 210 210 210 206 278 268 267 265 278 275
278 278 278 274 273 272 278 278 278 212 210 210 210 210 210 210 210 210 210 210 210 205 204 204 206 278 278 271 270 269 278 276
278 278 278 278 275 278 278 278 278 212 210 210 210 210 210 210 210 210 210 210 210 209 278 278 264 263 262 274 273 272 278 278
264 263 262 278 276 278 278 278 278 212 210 210 210 210 210 210 210 210 210 210 210 209 278 278 268 267 265 278 275 278 278 278
268 267 265 278 278 278 278 278 278 212 210 210 210 210 210 210 210 210 210 210 210 209 278 278 271 270 269 278 276 263 262 278
271 270 269 278 278 278 278 278 278 212 210 210 210 210 210 210 210 210 210 210 210 209 278 278 274 273 272 278 268 267 265 278
274 273 272 278 278 278 278 278 278 212 210 210 210 210 210 210 210 210 210 210 210 209 278 278 278 275 278 278 271 270 269 278
278 275 278 278 278 278 278 278 278 212 210 210 210 210 210 210 210 210 210 210 210 209 278 278 278 276 278 278 274 273 272 278
278 276 278 278 278 278 278 278 278 208 207 207 207 207 207 204 207 207 207 207 207 206 278 278 278 278 278 278 278 275 278 278
278 278 278 278 278 278 278 264 263 262 278 278 278 278 278 278 278 278 278 278 278 264 263 262 278 278 278 278 278 276 278 278
263 262 278 289 287 286 278 268 267 265 278 278 278 278 278 264 263 262 278 278 278 268 267 265 278 264 263 262 278 278 278 278
267 265 278 285 290 279 278 271 270 269 278 278 264 263 262 268 267 265 278 278 278 271 270 269 278 268 267 265 278 278 278 278
270 269 278 284 290 280 278 274 273 272 278 278 268 267 265 271 270 269 278 278 278 274 273 272 278 271 270 269 278 278 278 278
273 272 278 284 290 280 278 278 275 278 278 278 271 270 269 274 273 272 278 278 278 278 275 278 278 274 273 272 278 264 263 262
275 278 278 283 282 281 278 278 276 278 278 278 274 273 272 278 275 278 278 278 278 278 276 278 278 278 275 278 278 268 267 265
276 278 278 278 278 278 278 278 278 278 278 278 278 275 278 278 276 278 278 278 278 278 278 278 278 278 276 278 278 271 270 269