145 145 145 145 145 145 145 145 145 145 145 145 145 140 145 145 156 156 156 156
145 145 145 145 145 140 145 145 145 145 145 145 145 145 145 145 140 156 156 156
137 137 145 145 145 145 145 145 145 145 145 145 145 145 145 137 160 160 160 160
137 137 137 145 145 145 145 145 140 145 145 145 140 145 145 137 160 160 160 160
137 137 137 137 145 145 145 145 145 145 145 145 145 145 137 137 161 162 162 162
137 137 137 137 137 145 145 145 145 145 145 145 145 137 137 161 168 160 160 160
162 162 162 162 162 163 170 170 170 170 170 170 164 162 162 168 160 160 160 160
137 137 137 137 137 179 175 175 175 175 175 175 181 137 137 137 160 160 160 160
137 137 137 137 160 179 175 175 175 175 175 175 181 160 160 172 160 160 160 160
160 160 172 160 160 179 180 180 180 180 180 180 181 160 176 177 178 160 160 160
160 176 177 178 160 160 145 145 145 140 145 145 160 160 182 183 184 160 160 160
160 182 183 184 160 160 145 140 145 145 145 145 160 160 186 187 188 160 160 160
160 186 187 188 160 160 145 145 145 145 145 145 160 160 160 190 160 160 160 160
160 160 190 160 160 160 145 145 145 140 145 145 160 160 160 194 160 160 160 160
160 160 194 160 160 160 160 145 145 145 145 160 160 160 160 160 160 160 160 160
160 160 160 160 160 160 160 145 145 145 145 160 160 160 160 160 160 160 197 154
160 160 160 160 160 160 197 192 192 192 192 154 154 154 154 154 154 154 198 189
160 160 160 160 160 197 198 189 189 189 189 189 189 189 189 189 189 189 189 189
160 160 197 154 154 198 189 189 189 189 189 189 189 189 189 189 189 189 189 189
160 197 198 189 189 189 189 189 189 189 189 189 189 189 189 189 189 189 189 189
