307 465 300 300 300 300 300 300 300 300 300 300 300 300 300 300 300 300 300 300 300 300 479 307 
463 464 669 669 669 669 669 669 669 669 669 669 669 669 669 669 669 669 669 669 669 669 480 481 
326 669 669 669 474 474 669 470 472 473 669 669 669 669 669 669 474 474 669 669 475 476 669 329 
326 462 672 672 672 672 672 471 672 672 672 672 672 672 672 672 672 672 672 672 477 478 482 329 
326 673 466 308 327 327 308 330 331 332 308 488 489 308 469 308 327 327 308 308 301 302 483 329 
326 674 467 323 328 328 323 333 334 335 323 491 490 323 468 323 328 328 323 323 303 304 484 329 
326 324 324 324 324 324 324 310 314 309 324 324 336 324 324 324 324 324 324 324 305 306 324 329 
326 323 323 323 323 323 323 315 316 317 323 323 323 323 323 323 323 323 323 323 323 323 323 329 
326 324 324 678 679 680 681 324 324 324 324 324 324 324 324 324 324 324 324 324 324 324 324 329 
326 323 341 682 683 684 685 336 323 323 323 323 323 323 323 323 336 337 338 341 323 323 323 329 
326 324 324 686 687 688 689 324 324 324 324 324 324 324 324 324 341 339 340 341 324 324 324 329 
326 323 336 690 691 692 693 341 323 323 323 323 323 323 323 323 323 323 323 323 323 323 323 329 
326 324 324 694 695 696 697 324 324 324 324 324 324 324 324 324 324 324 324 324 324 324 324 329 
326 323 323 323 324 324 324 324 323 323 323 323 323 323 323 323 323 323 323 323 323 323 323 329 
326 324 324 324 324 324 324 324 324 324 324 324 324 324 324 324 324 324 324 324 324 324 324 329 
326 323 323 323 323 323 323 323 323 323 323 323 323 323 323 323 323 323 323 323 323 323 323 329 
326 324 324 324 324 324 324 324 324 324 324 324 324 324 324 324 492 493 494 495 496 324 324 329 
326 323 323 323 323 323 323 323 323 323 323 323 323 323 323 497 498 499 631 632 633 323 323 329 
326 324 324 324 324 324 324 324 324 324 324 324 324 324 324 634 635 636 637 638 639 324 324 329 
326 698 323 323 323 323 323 323 323 323 323 323 323 323 640 641 642 642 644 645 646 323 323 329 
326 699 702 705 324 708 711 324 324 324 324 324 324 324 647 648 649 650 651 652 653 324 324 329 
326 700 703 706 323 709 712 323 323 323 318 319 320 323 654 655 656 657 658 659 660 323 323 329 
326 701 704 707 324 710 713 324 324 324 311 312 313 324 661 662 663 664 665 666 667 324 324 329 
670 668 668 668 668 668 668 668 668 668 718 323 719 668 668 668 668 668 668 668 668 668 668 487 