343 354 365 424 424 424 387 428 424 424 424 424 424 424 424 424 363 364 
431 344 376 420 420 420 430 429 420 420 420 420 420 420 420 420 366 436 
431 345 346 346 346 346 346 346 347 346 346 346 346 346 346 346 368 436 
431 370 355 353 352 351 350 349 348 425 397 399 400 401 402 403 369 436 
431 371 356 357 358 359 360 361 362 394 410 408 407 406 405 404 425 436 
431 372 425 425 425 425 426 426 426 396 411 412 413 414 415 416 425 436 
431 373 425 425 425 425 388 389 390 396 423 422 421 419 418 417 425 436 
431 374 425 425 425 425 393 392 391 394 410 408 407 406 405 404 425 436 
431 375 425 425 425 425 426 426 426 396 411 412 413 414 415 416 425 436 
434 377 425 425 425 425 425 425 425 425 425 425 425 425 425 425 425 436 
434 380 383 385 385 385 385 385 385 385 385 385 385 385 385 385 425 436 
381 382 384 386 386 386 386 386 386 386 386 386 386 386 386 386 425 436 